α	Α
β	Β
γ	Γ
δ	Δ
ε	Ε
ζ	Ζ
η	Η
θ	Θ
ι	Ι
κ	Κ
λ	Λ
μ	Μ
ν	Ν
ξ	Ξ
ο	Ο
π	Π
ρ	Ρ
σ	Σ
τ	Τ
υ	Υ
φ	Φ
χ	Χ
ψ	Ψ
ω	Ω
ς 	Σ
ά	Ά
έ	Έ
ή	Ή
ί	Ί
ό	Ό
ύ	Ύ
ώ	Ώ
ϊ	Ϊ
ΐ	Ϊ
ϋ	Ϋ
ΰ	Ϋ